{
  "layer": "COMUNI",
  "property": "PRO_COM_T",
  "values": [
    "036012",
    "036013",
    "036014",
    "036015",
    "036016",
    "036017",
    "036018",
    "036019",
    "036020",
    "036021",
    "036022",
    "036023",
    "036024",
    "036025",
    "036026",
    "036027",
    "036028",
    "036029",
    "036030",
    "036031",
    "036032",
    "036033",
    "036034",
    "036035",
    "036036",
    "036037",
    "036038",
    "036039",
    "036040",
    "036041",
    "036042",
    "036043",
    "036044",
    "036045",
    "036046",
    "033001",
    "033002",
    "033003",
    "033004",
    "033005",
    "033006",
    "033007",
    "033008",
    "033010",
    "033011",
    "033012",
    "033013",
    "033014",
    "033015",
    "033016",
    "033017",
    "033018",
    "033019",
    "033020",
    "033021",
    "033022",
    "033023",
    "033024",
    "033025",
    "033026",
    "033027",
    "033028",
    "033030",
    "033032",
    "033033",
    "033034",
    "033035",
    "033036",
    "033037",
    "033038",
    "033039",
    "033040",
    "033041",
    "033042",
    "033043",
    "033044",
    "033045",
    "033046",
    "033047",
    "033048",
    "033049",
    "034001",
    "034002",
    "034003",
    "034004",
    "034005",
    "034006",
    "034007",
    "034008",
    "034009",
    "034010",
    "034011",
    "034012",
    "034013",
    "034014",
    "034015",
    "034016",
    "034017",
    "034018",
    "034019",
    "034020",
    "034022",
    "034023",
    "034024",
    "034025",
    "034026",
    "034027",
    "034028",
    "034030",
    "034031",
    "034032",
    "034033",
    "034035",
    "034036",
    "034038",
    "034039",
    "034040",
    "034041",
    "034042",
    "034044",
    "034045",
    "034046",
    "034049",
    "034050",
    "034051",
    "035001",
    "035002",
    "035003",
    "035004",
    "035005",
    "035006",
    "035008",
    "035009",
    "035010",
    "035011",
    "035012",
    "035013",
    "035014",
    "035015",
    "035016",
    "035017",
    "035018",
    "035020",
    "035021",
    "035022",
    "035023",
    "035024",
    "035026",
    "035027",
    "035028",
    "035029",
    "035030",
    "035032",
    "035033",
    "035034",
    "035035",
    "035036",
    "035037",
    "035038",
    "035039",
    "035040",
    "035041",
    "035042",
    "035043",
    "035044",
    "035045",
    "035046",
    "036001",
    "036002",
    "036003",
    "036004",
    "036005",
    "036006",
    "036007",
    "036008",
    "036009",
    "036010",
    "036011",
    "036047",
    "037001",
    "037002",
    "037003",
    "037005",
    "037006",
    "037007",
    "037008",
    "037009",
    "037010",
    "037011",
    "037012",
    "037013",
    "037014",
    "037015",
    "037016",
    "037017",
    "037019",
    "037020",
    "037021",
    "037022",
    "037024",
    "037025",
    "037026",
    "037027",
    "037028",
    "037030",
    "037031",
    "037032",
    "037033",
    "037034",
    "037035",
    "037036",
    "037037",
    "037038",
    "037039",
    "037040",
    "037041",
    "037042",
    "037044",
    "037045",
    "037046",
    "037047",
    "037048",
    "037050",
    "037051",
    "037052",
    "037053",
    "037054",
    "037055",
    "037056",
    "037057",
    "037059",
    "037060",
    "037061",
    "037062",
    "038001",
    "038003",
    "038004",
    "038005",
    "038006",
    "038007",
    "038008",
    "038010",
    "038011",
    "038012",
    "038014",
    "038017",
    "038018",
    "038019",
    "038022",
    "038023",
    "038025",
    "038027",
    "038028",
    "038029",
    "038030",
    "039001",
    "039002",
    "039003",
    "039004",
    "039005",
    "039006",
    "039007",
    "039008",
    "039009",
    "039010",
    "039011",
    "039012",
    "039013",
    "039014",
    "039015",
    "039016",
    "039017",
    "039018",
    "040001",
    "040003",
    "040004",
    "040005",
    "040007",
    "040008",
    "040009",
    "040011",
    "040012",
    "040013",
    "040014",
    "040015",
    "040016",
    "040018",
    "040019",
    "040020",
    "040022",
    "040028",
    "040031",
    "040032",
    "040033",
    "040036",
    "040037",
    "040041",
    "040043",
    "040044",
    "040045",
    "040046",
    "040049",
    "040050",
    "099001",
    "099002",
    "099003",
    "099004",
    "099005",
    "099006",
    "099008",
    "099009",
    "099011",
    "099013",
    "099014",
    "099015",
    "099016",
    "099017",
    "099018",
    "099020",
    "099021",
    "099022",
    "099023",
    "099024",
    "099025",
    "099026",
    "099027",
    "099028",
    "099029",
    "099030",
    "099031"
  ]
}
